1111111111111111111111111111111111111111111
1999999990000000000000000000000000999999991
1999999990000000000000000000000000999999991
1999999990009999999999999999999000999999991
1999999990009999999999999999999000999999991
1999999990009999999999999999999000999999991
1999999990009999999999999999999000999999991
1999999990009999999999999999999000999999991
1999999990009999999999999999999000999999991
1999999990009999999999999999999000999999991
1999999990009999999999999999999000999999991
1999999990009999999999999999999000999999991
1999999990009999999999999999999000999999991
1999999990009999999999999999999000999999991
1999999990009999999999999999999000999999991
1999999990000000000000000000000000999999991
1999999990000000000000000000000000999999991
1111111111111100011111111111111111111111111
1000000000000100011111111110000000000000001
1000000000000100011111111110000000000000001
1000000000000100011111111110000000000000001
1001111111111100011111111110000000000000001
1000000000000000000000000000000000000000001
1000000000000000000000000000000000000000001
1000000000000000000000000000000000000000001
1111111111111111111111111111111111111111111
